%%%%%%%%%
%   G   %
%       %
%   G   %
%   P   %
%   G   %
%%%%%%%%%
% % % %%%
%%%%%%%%%
